Introduction Screen	Cave Title
Room One	Caverns Entrance                   [Snorb]
Starter Cave	Into the Darkness                 [RT-55J]
Crossover Cave	Centipede Preserve
Red Cave	
Hell's Maw	Hell's Mouth - WIP                 [Snorb]
Locked Key	Trick Key
Castle Exterior	Castle of %#^@%!!                  [Snorb]
Almost There	Almost a Petting Zoo              [RT-55J]
Engineer Required	Engineering Rewired
Twisty Cave	Wispy Pave
Cave Gates	Z.U.T.S Redux                     [RT-55J]
House of Mirrors	House of Mirrors 2021 [Newt]
Forest	Bip-bo-Beep                    [Snorb/TGH]
Public Transport	Public Transport                [DarkMatt]
Pac-Man	Super Maze Chase Game
Sucker	The Sucker
Dueling Locks	Graveyard                         [RT-55J]
Key Puzzle	PrismaKey                       [DarkMatt]
Rainbow Road	Rainbow Road                      [RT-55J]
Heaven (WalkWay 3)	(falling from) Heaven
Hell Landing Point	City Dolent
Hell Board 1
Hell Board 2	Doomed Base                     [DarkMatt]
Hell Board 3	Catch the Devil
Hell Board 4	Hellen
Hell Blue Gates	Yomotsu Hirasaka                   [Snorb]
Viper Pit	Viper Pit                       [DarkMatt]
River Styx	
Depths of Hell	Hell Depths                        [dave2]
Devil's Quarters	The Management
End Game	The New There
